0000000000000000
0111111111111111
0100000000000001
0101111010000001
0101000000010001
0101000000000001
0101000000000001
0100000111110001
0100000000000001
0100011111000001
0100000000010001
0100000000000001
0100001000000001
0100001001000001
0100001000001001
0100001000001001
0100001001101001
0111111001001001
0111111000111001
0111111000000001
0111111111111111
